4 4 4 1 1 7 8 8 8 8 8 8 8 8 8 8 8 8 8  8 8 8 8 8 8 8 8 8 3 8 8 8 8 8 8 8 8 8  8 8 8 8 8 8 8 8 8 8 8 8 8 8 1 1 4 4 4
4 4 4 4 1 1 0 0 0 0 0 0 0 0 0 0 0 0 0  0 0 0 0 0 0 0 0 7 0 7 7 0 0 0 0 5 7 0  0 0 0 5 0 0 7 7 0 7 0 7 0 1 1 4 4 4 4
4 4 4 1 1 7 0 0 5 5 0 0 0 0 0 0 0 0 5  5 0 0 0 0 5 0 5 0 0 5 0 0 0 0 0 5 0 0  0 0 0 0 0 0 0 0 0 0 0 0 0 0 1 4 4 4 4
4 4 4 1 1 1 0 0 5 5 0 0 0 5 7 0 0 0 0  0 0 0 0 0 0 0 0 0 0 0 0 0 0 5 0 0 0 0  0 0 0 0 5 5 0 0 0 0 0 0 0 1 1 4 4 4 4
4 4 4 1 1 1 0 0 0 0 0 0 0 7 0 0 0 0 0  0 5 5 0 0 0 0 0 5 0 0 0 0 0 0 0 0 7 0  0 0 0 0 5 5 0 7 0 0 7 0 0 1 1 1 4 4 4
4 4 4 4 1 7 0 0 0 0 0 5 0 0 0 0 0 0 0  0 5 5 0 0 0 0 0 0 0 0 0 5 0 0 0 0 0 0  0 0 0 0 0 0 0 0 0 0 0 5 0 0 1 1 4 4 4
4 4 4 1 1 0 0 0 0 0 0 0 0 0 0 5 0 0 0  0 0 0 0 0 0 5 0 0 0 0 0 0 0 0 0 5 0 0  0 0 5 0 5 0 0 0 0 0 0 5 5 0 1 4 4 4 4
4 4 4 4 1 0 0 5 0 5 0 0 0 0 0 0 0 0 0  0 0 5 0 0 0 5 0 0 0 0 0 0 0 0 0 5 0 0  0 0 0 0 5 0 5 0 0 0 7 0 0 0 1 1 4 4 4
4 4 4 1 1 1 0 0 0 0 0 0 0 0 0 0 0 0 0  0 0 0 0 5 0 0 0 0 0 5 0 0 5 0 0 0 0 0  0 0 0 0 0 0 0 0 0 0 5 0 0 1 1 4 4 4 4
4 4 4 1 1 1 0 0 0 10 0 5 0 0 5 0 0 0 0  0 0 0 0 0 0 7 0 0 0 0 0 0 0 0 0 0 0 0  0 0 0 0 5 5 0 0 0 0 0 0 0 0 1 1 4 4 4
4 4 4 4 1 0 0 0 0 0 0 0 0 0 0 0 0 0 0  0 0 0 0 0 0 0 0 0 0 5 0 0 0 5 0 0 0 0  5 0 0 0 0 0 5 7 0 0 0 0 0 0 1 1 4 4 4
4 4 4 1 1 1 0 0 5 0 0 0 5 0 5 0 0 0 0  0 0 0 5 5 0 0 5 0 0 0 0 0 0 5 5 0 0 0  0 5 0 0 0 0 0 0 0 5 5 0 0 1 1 4 4 4 4
4 4 4 1 1 0 0 0 0 0 0 0 0 0 0 0 0 0 0  5 0 0 5 0 0 0 0 0 0 0 0 0 0 0 0 0 0 0  0 0 0 0 0 0 0 0 0 5 5 0 0 1 1 4 4 4 4
4 4 4 4 1 7 0 0 0 5 0 0 7 0 0 0 5 0 0  0 5 0 0 0 0 0 0 5 7 0 0 0 0 0 0 0 0 0  0 0 0 7 5 0 0 0 0 0 0 0 0 0 1 1 4 4 4
4 4 4 1 1 1 0 0 0 5 0 0 0 0 5 0 0 0 0  0 0 5 0 5 5 0 0 0 0 0 0 0 0 5 0 0 0 0  0 0 0 5 5 0 5 5 0 5 0 0 0 1 1 1 4 4 4
4 4 4 4 1 1 0 5 0 0 0 0 0 0 0 0 0 0 0  0 0 0 0 0 0 0 0 0 0 0 0 0 0 0 5 0 0 0  0 0 0 0 0 0 5 5 0 0 0 0 0 0 1 4 4 4 4
4 4 4 1 1 0 0 0 0 0 0 0 5 7 0 0 5 0 0  0 0 0 0 0 0 5 0 0 0 0 5 5 0 0 0 0 0 0  0 0 0 0 7 0 0 0 0 0 0 0 0 1 1 4 4 4 4
4 4 4 1 1 1 0 0 5 0 5 0 0 0 5 0 0 0 0  0 0 5 5 0 0 0 0 0 0 0 0 0 0 0 0 0 0 0  5 5 0 0 0 0 0 0 0 0 5 0 0 0 1 4 4 4 4
4 4 4 4 1 7 0 0 0 0 0 0 0 0 0 0 5 0 0  0 0 5 5 0 0 0 0 5 5 0 0 0 5 5 0 0 0 0  0 5 0 0 0 0 0 5 0 0 0 0 0 0 1 1 4 4 4

4 4 4 1 1 0 0 0 0 0 0 0 0 0 0 0 0 0 0  0 0 0 0 0 0 0 0 0 0 0 0 0 0 0 0 0 0 0  0 0 0 0 0 0 0 0 0 0 0 0 0 0 1 1 4 4 4
4 4 4 4 1 1 0 0 0 0 0 0 0 0 0 0 0 0 0  0 0 0 0 0 0 0 0 7 0 7 7 0 0 0 0 5 7 0  0 0 0 5 0 0 7 7 0 7 0 7 0 1 1 4 4 4 4
4 4 4 1 1 7 0 0 5 5 0 0 0 0 0 0 0 0 5  5 0 0 0 0 5 0 5 0 0 5 0 0 0 0 0 5 0 0  0 0 0 0 0 0 0 0 0 0 0 0 0 0 1 4 4 4 4
4 4 4 1 1 1 0 0 5 5 0 0 0 5 7 0 0 0 0  0 0 0 0 0 0 0 0 0 0 0 0 0 0 5 0 0 0 0  0 0 0 0 5 5 0 0 0 0 0 0 0 1 1 4 4 4 4
4 4 4 1 1 1 0 0 0 0 0 0 0 7 0 0 0 0 0  0 5 5 0 0 0 0 0 5 0 0 0 0 0 0 0 0 7 0  0 0 0 0 5 5 0 7 0 0 7 0 0 1 1 1 4 4 4
4 4 4 4 1 7 0 0 0 0 0 5 0 0 0 0 0 0 0  0 5 5 0 0 0 0 0 0 0 0 0 5 0 0 0 0 0 0  0 0 0 0 0 0 0 0 0 0 0 5 0 0 1 1 4 4 4
4 4 4 1 1 0 0 0 0 0 0 0 0 0 0 5 0 0 0  0 0 0 0 0 0 5 0 0 0 0 0 0 0 0 0 5 0 0  0 0 5 0 5 0 0 0 0 0 0 5 5 0 1 4 4 4 4
4 4 4 4 1 0 0 5 0 5 0 0 0 0 0 0 0 0 0  0 0 5 0 0 0 5 7 5 0 5 7 0 0 0 0 5 0 0  0 0 0 0 5 0 5 0 0 0 7 0 0 0 1 1 4 4 4
4 4 4 1 1 0 4 0 0 4 0 0 4 0 0 0 4 4 0  0 0 0 0 4 0 0 5 0 0 0 5 0 5 0 0 0 0 0  0 0 0 0 0 0 0 0 0 0 5 0 0 1 1 4 4 4 4
4 4 4 4 4 4 4 4 4 4 4 4 4 4 4 4 4 4 4  4 4 4 4 4 4 7 0 0 2 0 0 0 0 0 0 0 0 0  0 0 0 0 5 5 0 0 0 0 0 0 0 0 1 1 4 4 4
4 4 4 4 1 0 4 0 0 0 4 0 0 4 0 0 0 0 4  0 4 4 4 0 0 0 5 0 0 0 5 0 0 5 0 0 0 0  5 0 0 0 0 0 5 7 0 0 0 0 0 0 1 1 4 4 4
4 4 4 1 1 1 0 0 5 0 0 0 5 0 5 0 0 0 0  0 0 0 5 5 0 0 7 5 0 5 7 0 0 5 5 0 0 0  0 5 0 0 0 0 0 0 0 5 5 0 0 1 1 4 4 4 4
4 4 4 1 1 0 0 0 0 0 0 0 0 0 0 0 0 0 0  5 0 0 5 0 0 0 0 0 0 0 0 0 0 0 0 0 0 0  0 0 0 0 0 0 0 0 0 5 5 0 0 1 1 4 4 4 4
4 4 4 4 1 7 0 0 0 5 0 0 7 0 0 0 5 0 0  0 5 0 0 0 0 0 0 5 7 0 0 0 0 0 0 0 0 0  0 0 0 7 5 0 0 0 0 0 0 0 0 0 1 1 4 4 4
4 4 4 1 1 1 0 0 0 5 0 0 0 0 5 0 0 0 0  0 0 5 0 5 5 0 0 0 0 0 0 0 0 5 0 0 0 0  0 0 0 5 5 0 5 5 0 5 0 0 0 1 1 1 4 4 4
4 4 4 4 1 1 0 5 0 0 0 0 0 0 0 0 0 0 0  0 0 0 0 0 0 0 0 0 0 0 0 0 0 0 5 0 0 0  0 0 0 0 0 0 5 5 0 0 0 0 0 0 1 4 4 4 4
4 4 4 1 1 0 0 0 0 0 0 0 5 7 0 0 5 0 0  0 0 0 0 0 0 5 0 0 0 0 5 5 0 0 0 0 0 0  0 0 0 0 7 0 0 0 0 0 0 0 0 1 1 4 4 4 4
4 4 4 1 1 0 0 0 0 0 0 0 0 0 0 0 0 0 0  0 0 0 0 0 0 0 0 0 0 0 0 0 0 0 0 0 0 0  0 0 0 0 0 0 0 0 0 0 0 0 0 0 1 1 4 4 4
4 4 4 4 1 1 0 0 0 0 0 0 0 0 0 0 0 0 0  0 0 0 0 0 0 0 0 7 0 7 7 0 0 0 0 5 7 0  0 0 0 5 0 0 7 7 0 7 0 7 0 1 1 4 4 4 4

4 4 4 1 1 7 7 0 0 0 0 0 0 0 0 0 0 0 0  0 0 0 0 0 0 0 5 0 0 0 0 0 0 0 0 0 0 0  0 0 0 0 0 0 0 0 0 0 0 0 0 0 1 1 4 4 4
4 4 4 4 1 1 0 0 0 0 0 5 0 0 0 0 0 0 0  0 5 5 0 0 0 0 5 5 0 0 5 5 0 0 0 0 0 0  0 0 0 0 0 0 0 0 0 0 0 0 0 1 1 4 4 4 4
4 4 4 1 1 7 0 0 0 5 0 0 0 0 0 0 0 0 0  0 0 5 0 0 0 0 0 0 0 0 5 0 0 0 0 0 0 0  0 0 0 0 0 0 0 0 0 0 0 0 0 0 1 4 4 4 4
4 4 4 1 1 1 0 0 0 0 0 0 0 0 0 0 0 0 0  0 0 0 0 0 7 0 0 0 0 0 0 0 0 0 0 0 0 0  0 0 0 0 0 0 0 0 0 0 0 0 0 1 1 4 4 4 4
4 4 4 1 1 1 0 5 5 0 0 5 0 0 0 0 5 0 0  0 0 0 0 0 7 7 0 0 5 0 5 0 0 0 0 0 0 0  0 0 0 0 0 0 0 0 0 0 0 0 0 1 1 1 4 4 4
4 4 4 4 1 7 0 0 0 0 0 0 0 0 0 0 0 0 0  0 0 0 0 0 0 0 0 0 0 0 0 0 0 0 0 5 5 0  0 0 0 0 0 0 0 0 0 0 0 0 0 0 1 1 4 4 4
4 4 4 1 1 7 0 0 0 0 0 0 5 5 0 0 0 0 0  0 0 0 0 0 0 0 5 5 0 0 5 0 0 0 0 5 0 0  0 0 0 0 0 0 0 0 0 0 0 0 0 0 1 4 4 4 4
4 4 4 4 1 7 0 0 0 5 0 0 5 7 0 0 0 0 0  0 0 0 0 5 0 0 5 5 0 0 5 0 7 0 0 0 0 0  0 0 0 0 0 0 0 0 0 0 0 0 0 0 1 1 4 4 4
4 4 4 1 1 1 0 0 0 7 0 0 0 0 0 0 7 0 0  0 0 0 0 0 0 0 0 0 0 0 0 0 0 0 0 0 0 0  0 0 0 0 0 0 0 0 0 0 0 0 0 1 1 4 4 4 4
4 4 4 1 1 1 0 0 0 5 0 0 0 0 0 0 7 0 0  0 0 0 0 0 0 0 0 0 0 0 0 0 0 0 0 0 0 0  0 0 0 0 0 0 0 0 0 0 0 0 0 0 1 1 4 4 4
4 4 4 4 1 7 0 0 0 0 0 0 0 0 0 0 0 0 5  5 0 0 0 5 5 0 0 0 0 7 5 0 0 0 0 0 0 0  0 0 0 0 0 0 0 0 0 0 0 0 0 0 1 1 4 4 4
4 4 4 1 1 1 0 0 0 0 0 0 5 0 0 0 0 0 5  5 0 0 0 0 0 0 0 0 0 0 5 0 0 0 0 7 0 0  0 0 0 0 0 0 0 0 0 0 0 0 0 1 1 4 4 4 4
4 4 4 1 1 7 0 0 0 0 0 0 0 0 0 0 0 0 0  0 0 0 0 0 0 0 0 0 0 0 0 7 7 0 0 7 0 0  0 0 0 0 0 0 0 0 0 0 0 0 0 1 1 4 4 4 4
4 4 4 4 1 1 0 0 1 0 1 0 0 0 1 0 1 0 0  0 1 1 0 7 0 1 0 1 7 0 1 1 7 0 0 1 1 0  0 1 1 0 0 0 1 0 1 1 0 1 0 0 1 1 4 4 4
4 4 4 1 1 1 1 1 1 1 1 1 1 1 1 1 1 1 1  1 1 1 1 1 1 1 1 1 1 1 1 1 1 1 1 1 1 1  1 1 1 1 1 1 1 1 1 1 1 1 1 1 1 1 4 4 4
4 4 4 4 1 4 1 4 1 4 4 1 4 1 1 1 4 1 1  4 4 1 4 1 1 1 4 1 4 1 1 4 4 1 4 1 1 4  4 1 4 1 1 4 1 1 4 1 4 4 1 4 1 4 4 4 4
4 4 4 4 4 4 4 4 4 4 4 4 4 4 4 4 4 4 4  4 4 4 4 4 4 4 4 4 4 4 4 4 4 4 4 4 4 4  4 4 4 4 4 4 4 4 4 4 4 4 4 4 4 4 4 4 4
4 4 4 4 4 4 4 4 4 4 4 4 4 4 4 4 4 4 4  4 4 4 4 4 4 4 4 4 4 4 4 4 4 4 4 4 4 4  4 4 4 4 4 4 4 4 4 4 4 4 4 4 4 4 4 4 4
4 4 4 4 4 4 4 4 4 4 4 4 4 4 4 4 4 4 4  4 4 4 4 4 4 4 4 4 4 4 4 4 4 4 4 4 4 4  4 4 4 4 4 4 4 4 4 4 4 4 4 4 4 4 4 4 4